###### 
#  @ #
#. $$#
#   .#
######