####### 
#  @  #
#.$$$ #
#.  . #
#######